########################################
#......................................#
#......................................#
#....#.........#.............#.........#
#....#.........#.......................#
#....#.........#.......................#
#..............#.......................#
#..............#.......................#
#.........................#######......#
#......................................#
#......................................#
#......................................#
#........#######..........#............#
#................................#.....#
#......................................#
#....................#.................#
#.........#............................#
#.........#............................#
#.........#............................#
#.........#.......#....#######.........#
#.........#............................#
#......................................#
#......................................#
#......................................#
#......................................#
#......................................#
#...........#######...........#........#
#....#........................#........#
#.............................#........#
#.............................#........#
#...........#######...........#........#
#......................................#
#......................................#
#........................#.........#...#
#.....#.....#######....................#
#......................................#
#............................#.........#
#......................................#
#......................................#
########################################